NO ./path_to_the_north_texture
SO ./path_to_the_south_texture
F 220,100,0


EA ./path_to_the_east_texture


C 225,30,14

WE ./path_to_the_west_texture

1111111
1000111
1100001
1111111
11
      111111111
     1100000011
    1100000000011
    10001111111111
 11110011        1
1110010011        1
110010001111111111
11001000000000001
11001000011000001
110010000010000011
1100100E000000001
110010000010000011
 1111111111110001
    100001 100001
    100001 100001
1    1111   1111
    111111 111111
