

NO ./path_to_the_north_texture
SO ./path_to_the_south_texture
F 220,100,0

EA ./path_to_the_east_texture


C 225,30,0


WE ./path_to_the_west_texture




1111111
1000111
1100001
1111111
11
      111111111
     11000000011
    1100000000011
    10001111111111
 11110011        1
11 0010011        1
110010001111111111
11001000000000001
11001000000000001
1100100000N000001
11001000000000001
11001000000000001
 1111000011110001
    100001 100001
    100001 100001
    111111 111111