
NO ./textures/north.xpm
SO ./textures/south.xpm


C 155,200,220

F 220,100,12

EA ./textures/east.xpm

WE ./textures/west.xpm

1111111
1000111
1100001
1111111
11
      111111111
     1100000011
    1100000000011
    10001111111111
 11110011        1
1110010011        1
110010001111111111
11001000000000001
11000011101000001
110010000010000011
1100100S000000001
110010000010000011
 1111110111110001
    100001 100001
    100001 100001
1    1111   1111
    111111 111111
