


NO ./path_to_the_north_texture
SO ./path_to_the_south_texture


C 255,300,222

F 220,100,0

EA ./path_to_the_east_texture

WE ./path_to_the_west_texture



111111
100001
100N1
1001
11111




