
NO ./textures/messi_arg.xpm
SO ./textures/messi_barca.xpm


C 255,200,225

F 220,100,0

EA ./textures/messi_miami.xpm

WE ./textures/messi_young.xpm




111111111
100000001
100101101
100000001
100000001
100000001
100000001
1000W0001
111111111


