


NO ./path_to_the_north_texture
SO ./path_to_the_south_texture


C 255,200,000000000000000222

F 220,100,0

EA ./path_to_the_east_texture

WE ./path_to_the_west_texture




11111111
1000N011
10000011
10000011
10000011
111111


