
NO ./textures/north.xpm
SO ./textures/south.xpm


C 155,200,220

F 220,100,12

EA ./textures/east.xpm

WE ./textures/west.xpm




111111111
100000001
100101101
100000001
100000001
100000001
100000001
1000E0001
111111111


