
           NO ./textures/north.xpm                  
SO ./textures/south.xpm


C 155,200,220

F 220,100,12

    EA ./textures/east.xpm 

WE              ./textures/////////////../textures//west.xpm


111111111111111111111111111111111111111111111111111111111111
1000000000000000000000000000000000000000000000000000000000001
100101100000000000000000000000000000000000000000000000000001
111111111111111111111111111111111111111111111111111111111111
1                                    11                   1
111111111111111111111111111111111111111111111111111111111111
10000000000000000000000000000000000000000000000000000000001
1000000010000000000000000000000000000000000000000000000001
100000000000000000000000000000000000000000000000000000001
100000000000000000000000000000000000000000000000000000001
1000E0000000000000000000000000000000000000000000000000001
111111111111111111111111111111111111111111111111111111111111111111111111111
100001
 1111
