
        NO ./textures/north.xpm                  
SO ./textures/south.xpm


C 155,200,220

F 220,100,12

    EA ./textures/east.xpm 

WE              ./textures/////////////../textures//west.xpm


11111111111111111111
10000000000000000001
10000000000000000001
11110000000111000001
10010000000000000001
10010000000N00000001
10000000000000000111
10000000000000000001
11111111111111111111
