WE ./path_to_the_west_texture



NO ./path_to_the_north_texture
SO ./path_to_the_south_texture
F 240,100,0

EA ./path_to_the_east_texture


C 225,30,0




        1111111111111111111111111
        1000000000110000000000001
        1011000001110000000000001
        1001000000000000000000001   111111
        1111111111111111111111111   100001
                                    100001    
        1111111111111111111111111   100001
111111111011000001110000000000001   111111
100000000011000001110111111111111
1110111111111011100000011000001
111101111111110111010100100011
11000000110101011100000010001
10000000000000001100000010001
10000000000000001101010010001
11000001110101011111011110N0111
11110111 1110101 101111010001
11111111 1111111 111111111111



