


NO ./path_to_the_north_texture
SO ./path_to_the_south_texture
F 220,100,0

EA ./path_to_the_east_texture


C         225,30,0


WE ./path_to_the_west_texture




 

 
        111111111111111111111111                              11111111
        1000000000110000000000001
        1011000001110000000000001
        10010000000000000000000011
11111111101100000111000000000000101
1000000000110000011111111111111111
11110111111111011100000010001
11110111111111011101010010001
11000000110101011100000010001    111111
10000000000000001100000010001     100101
10000000000000001101010010001      11 11
11000001110101011111011110N0111
11110111 1110101 101111010001
11111111 1111111 111111111111
  11111111
  111000001 
  11111111
